111111111111111111111111111111111111111111111111
1P0000000000000000000000000000000000000000000001
1CCCCCCCCCCC000000000000000000000000000000000001
111111111111111000000000000000000000000000000001
111111111111111000000000000000000000000000000001
100000000000000000000000000000000000000000000001
100000000000000000000000000000000000000000000001
100000000000000000000000000000000000000000000001
100000000000000000000000000000000000000000000001
100000000000000000000000000000000000000000000001
1E0000000000000000000000000000000000000000000001
111111111111111111111111111111111111111111111111